11111111111111111111111
10000000000000000000001
10i0i0i0i0i0i0i0i0i0i01
10000000000000000000001
10i0i0i0d0d0d0d0i0i0i01
10000000000000000000001
10i0i0i0d00000d0i0i0i01
10000000000000000000001
10i0i0i0i0i0i0i0i0i0i01
10000000000000000000001
10i0i0i0i0i0i0i0i0i0i01
10000000000000000000001
11111111111111111111111